##################################
#~ #    ##   #     #   # +   #   #
#  + #  #  # # ### # # # #   + # #
####    ## ###/### # # # #########
#  ##+###  / # #   # # #         #
##  + #    ###+# ### # #+##  ### #
#   # +    +   #     #   #       #
############################## ###
#               ###      #       #
#  #####  ####  +   ## # ##+#+#+##
#               ###  #      # #  #
##################################
$03,03,1

