##################################
#  #    ##   #     #   # +   #   #
#  + #  #  # # ### # # # #   + # #
####    ## ###/### # # # ####### #
#  ##+###  / # #   # # #         #
##  + #    ###+# ### # #+##   #  #
#   # +    +   #     #   #       #
##########################+### ###
#               ###      #       #
#  #####  ####  +   ## # ##   +  #
#               ###  #           #
##################################
$09$31$3

